111111111111111111111111111111111111111111111111111111111111111111111111111111111111111111111111111111111111111111111111111111111111111111111111111111111111111111111111111111111111111111111111111111111
000000000000000000000000000010000000000000000000000000000000000000000000000000000000000000000000000000000000000000000000000000000000000000000000000000000000000010000000000000000000000000000000000000001
111011101111111111111011111011101110001111111011100011111111111110111011101110111011111011111110111011101111101011111111101011101111111011101110111010111111100010111011111011111000111011111010111110101
101010101010000000001000001000100010001000001010100010001000000010101010101010101010001010000010001010101000101010000010101010101000001010001010001010101000100010101010001010001000101010000010100000101
101110101010111011101110111110111110111011101110111010111011111011101110101011101110111011101110101010101110101011101010101010101110111011101010111010101010100011101010101011101011101110101110111111101
100000001010101000100010100010000000100010100000001010000000001000000010101000000000000000101000101000100000101000101000100000100010000000101010101010101010100000001010101000100010000000101000101000001
101111101010101110111010101010001110111110111111101010111011101110111010101000111111111110101000111011101111101111101111101110101011100011111010101011101010111011101110111010111010111011101111101011101
101000101000100010001010101010001010000000000000101000101010100000101010101000100000000000101000000010001000000010000000001010101000100010000010101000101010001010000000000010001010101010000000100010101
101011101011101111111010101010111011101111101111101110101010101111101110101110111111111111101000000011101111111011101011101010101010101010111110101011101110111010101110111010001110101011111110111010101
101010001000000000000010101010000000100000101000001010101000101000000000001010000000000000001000000000001000001000101010101010101010101010100000000010000000101010101010001010000000100000000010001010001
101011111011111111111010111011101111101111101011101010101111101111111011101011101110111110111000000011101011101011101010101011101010101010101110101110111011101011101011111110111010101110111010101011101
101000000010000000001010000000101000001000001010100010100000000000001010100000101010100010100000000010101000101010001010101000000010101010100010101000101010001000001000000000101010101000101000101000101
101000111011111111101110111111101111101111101010101110101110111000001110111000111011101110111111111010101011101110111010101010111110101010111011101110101110001111111010111111101010111011101110111011101
101000100010000000000000100000000010100010101010101000101000101000000000001000000000001000000000001000001000000000100010100010100010100010001000100010100000000000000010100000001010000010100010000010001
101111101110111111101111101111111110111110101110101111101110101000000011101110101111101110111011101111101110111111101110111011101010111010101010101110111000001011111110111011111010111010111011111011101
100000001000100000101000000000000010000000100000100000000000101000000010100010001000100010101010101000100010100000000000001000001010001010101010001000001000001000100000001010000010101000001000001000101
101111101011101110101011111111101110111111101011101111111111101111101110101011101011101110101110111010111110100011101110101011101110001110101011111011101011101110101111101011111011101011101111101011101
101010101010001010101000000000101000000000001010001000000000000000101000101000100010001000000000000010000000100010101010101010100000000000001010100010100010100010101000101000001000100010100000100010001
101010101011101010101011101111111011100000001111101110111111111011101110101111101110111011111111101110111110100010111011111010111011111011111010101110111110101110101110111011101110101110100000111110101
101010001000101010101000101000000000100000000000100010100000000000001000100000000000100010000000101000000010100010000000000010001010000010000010001000100000101000101000000000100010101000100000001000101
101011111011101011101110101111111111101111111010111010111011101110111011101111111111101110001110101110111010101110111111111011101011111011111110111011101110101011101111111011101110101110100000001110111
101000100010001000000010100010000000000000001010001010000010101010100010000000000000001010001000100000101000101000000000001000101000001000000000100010000010101010000000001010100000100010000000000010001
101110111011101110111011100011101111111010111011101110001110101011101111111111111110111010001110111110101110111010111011101111101111101111101110111011111010101010111111101110111010101110111111101110101
100010001010100010100000000000101000101010100000000000001000101000001000000000000000100010000010000010000010000000101010100000000000100000101010001000001010101010100010000000001010101000101000100000101
101110101010101011101110111011101110101011101110111000001010111011101111101111111111100010111110111011111010111110101110111110111011101110101011101110101110101110111011111011101011101011101110111011101
101000101000101000001010101010000010101000001000101000001010000010100000101000000000000010100000101000001010100010100000000000100010100000101000100010100000100000001000100010100000001010000010001000001
101111101110101110111011101010111010101110101111101111101110111110101011101110111000111110101110101111101110101110101111111111101110111110101011100011101110111110101010111110111011101011100011101111101
100000000010100010100000000010101010100010100000000000100000000000101010000010001000100000101000100000100000001000101000000000001000000010100010000000000010000010101010000000101010100000100000100000101
101111111010111010111111101110101010111011101111101010101111111011101011111010111110111111101111101110101111101011101000001111101011101110101010111111111111111011101010111011101010111110101110101111101
101000001010000010000000101000100010001010001000101010100000101010001000001010100010000000000000001010001000101010001000001000101010101000101010100000000000000000001000100010001010000010101010001000001
101011101010111011101110111011101011101011101011101110101110101011101011101110101110111011101111111010111010101110001000001110101110101111101110101111101111111111101110101110111011111011101011111000111
101010101010101010100010000000001000101000100010000000101010101000101010100000001000101010101000000010100010100000001000000010100000101000000010001000101000001000100010101000100000000000001000100000101
101010111011101010111111111111101111101011101110001110111010101110101010111011101000101110101110111011100010111111101110001110111111101111100010111011101111101110101110101010111110111111101110111011101
100010000000001010000000000010000000000010000000001010000000100010101010001010101000100000100010101000000000000000100010001000000000000000100010100000000000100000101000101010000000100000000010001010001
101110111111111011101111111111101011111110111000001011111110111011101011101110101110101111101110101110101111101110111011101011111011101110111010111111111011101110101010101111101011101111100010111011101
101000100000000010100000000000101010100000001000001000000010001000001000100000100010101000001000101010101000101010001000101010100010101010001010000000001010001010101010100000101010000000100010100000101
101011101111111110111111111011101110101110111000001111101010001110111011101110111011101111101111101011101010101011111011101010111010111011101010111010111010101011101010101110101011111111101110111111101
101010001000001000000000001000000010101010100000000000001010000010100000001010001000000000100000001000001010101000000010101010001000000000101010000010100010101000001000101010101000000000001000000000001
101010101000001011101111111011111010101010111011101110111110111110111011111010101011101111101111101011101010111000001110111011101011100011101011111110101011101111111000111010111011111000111011111111101
101010101000001010100000000010001000101010000010101010100000100010001010000010101010101000000000100010101010000000001000000000101010100010001000000010101000000000000000000010000010001000100010000000101
101010101011111010111110111010101110111011111110111010111011101110111010000010101110101011111111101110111011101111101011101110101110100011111010111011101110101111101110101011111011101111101110001110101
101010101010001010000010101010100010000000000000000010001000001000100000000010000000101000000010001000000000101000101010101010101000100000000010101000000010101010101010101000001000000000001000001010101
101010111011101011101010101010111010111110111011101110001011111011101110001110111011101111101110001111111111101011101010101011101110101110111011101111111110111010111010101110111000111110101011101011101
101010000000001000101010101010000010100010001010001000001010000010001010001000101010000000000000000000000000001000001010101000000000100000101010000000000010000010000010100010100000100010001000001000001
101110111011101011101011101110111011100011111011111000001110000011111011111011101110111011111110000011101111101111101110111011101110111110101110111111111011111011101110111010100000111011101111101011101
100000101010101010001010000000101000000000000000000000000000000000000000000010000000100010100010000010100010101000100000001000101010000010000000100000001000001000001000101000100000001000101000101000101
101111101010101010101010111011101011101110001111111110111110111111101110000010000011101110111011111110111010101110111011101111101011101011101111111110111011101011111010101111100011111011101011101111101
101000001010101010101000101010000010101010001000000010100010100000001010000010000010001000000000000000001010100000100010100000001000101000101000000010000010101010000010100000000010000000100010000000001
101111101010111010101011101110111010101011111110111011101110111011101010111110111111101011111011101110111010111110111010111111111011101111101110111011111010111011100011101110101011101111101110111111101
100010001010000010101010000000101000100000000000101000001000100010101010100000100000001000001010101010100010000000001010000000000010100000100010000000001010000000000000001010101000101000001000000010001
101010111011111010101010111110101011101110000011101111101110111110111011101110111111101111101110111010101110111111101010111011101110101110111010111111111010111111111011101010101011101110111011111110111
101010100000001010101010100010101010001010000010000000101010000000000000000010000000100000100000000010101000100000101010100010001000100010001000101000001010100000001000101010100010000010100010000000101
101110100011101110101010111011101010111011111110000000111010111110111110111111101110101110111111101110101011101111101010101011101011101110001011101111101010101111101011111010101110111110101110111011101
100000100010000000000010001000001010100000001000000000000000100010101000100000101000101010100000001000100010001000001010101010101010000000001010000000101010101000101010000010101000000000101000101010001
101110111011100011111010101011111110101111101000001111101111100011101111101111101110111011100000111010111110101111101110111010111010111111101011101111101010111011101010111010101110101110101011101010001
101000001000000010001010101000000000101000101000000000001000000000100000001010000010000000000000100010000000100000100000000010000000101000101000100000001000000010001000101000101010101000101010001010001
101110111011100011101010101110111011101011101110111110111011111000101011101011101110111011100000111011111000111110111011111010111011101011101110111111101011111110101011101111101011101110101010001011101
100010100010100000101010100010101010000010000010100000100010001000101000100000101000101010100000001000000000001010001010001010101000001010000010000000101010000000101010000000000000000010101010001000101
101110111010111111101010111110101011111010111110101110101110111110101110111110101110101010100000001110111011101010111011101010101111101011101110111110101011111110101010101111111111111110101110001110101
101000100010000000001010000000000000001010100000101010101000100010100010000010100010001000100000000010101010101010100000100010100000101000101000100000101000000010101010101000000000000000000000000010101
101011101110111011111010111011100000001110101111101011101011101011100011100010111011101110111110111110101110101010101110111010111011101110111000111111101111111011101010111011111110101110111011111011101
100010101000101010000010101010100000000000100010001000001010001000000000100010001000100010000010100000100000101010100010001010000010000000000000000000000000001000001010100000000010101010100010000000101
111010101110101110111011101110100000111110111011101111101011111000111000100011101110111011111011100000101011101010111010101110111011111110111011111010101111101111111010111000111010111010111110111111101
101010100010000000101000000000100000100010001000100000100000000000101000000000000010001010001000000000101010101010001010100000101000000010100010001010101000100000000010101000100010000010000000100000001
101010101110111110101111101111101111111011111011101110101110111111101000111011111010111011101010111110111010111010101110111111101111111110111011101010101011111011111010101110111010111010111011101111101
101000101000001010100000100010101000001000000010001010101010100000001000100010001010100000001010000010000010000000100000000000001000000000001000101010101000001010000010000010000010100010101010000000101
101111101011111010111011101110111011101011101110001010111010101010101011101110101010111110111011101010000011101011101111111111101011111010111011101010101111101010111110111011101110111011101011111000101
100000001010000010000000001000000010101000001000001010000010101010101010001000101010001010100000101010000000101010001010000000101010000010101010000010100000101010100000101000101000001010000000001000101
101110111010111010111011101110101110111011101011101010111110111011101110111010101010111010111110111011111110111011111011101111101010111110101111111010111000101011101011101111101110111011101111101000101
101010100010101010001010100010101000000010101010101000000000001000000000101000101010100010000010000000000010000000001000100000001010100000000000001010001000100000000010000000000010100000101000101000101
101010101110101011101110101011101011101110111010101110111111101011111111101111101110111011111010111110111111111011101011101110101110111010111110111011101110101110111011111110111110111011101011101011101
101010101000001000100000101000001010101010000000100010100000101010100000000000000000001000001010101000100000001010101000001010100000001010100010100000100010100000101000000010100000101010101010001010101
101010101111101110111010111011111010101010111110111110111010111010111111111110111111101110111010101011101011101010101110111011111110101110111010111000111110101111101011111010111111101010101011111010101
101010000000100010001010000010000010100010100010001010001010000010000000000010100000100010100010100010001010100010100010100000000010100000000010001000000010101000001010001010000000001000101000000000101
101011111110111011101110111110111110111110111011111010101011101110001111101110101110111110101110101110111110111010111010101011111110111011111011101000111011101111101010111011100000111011101110111110101
101000000010001000100010100000000010000000001000000010101000101000001000101000101010000000101000101000000000000010000010101010000000001010001000101000101000000000100010100000100000100010000000100010101
101111111010101110101010111011101010111111101011111010101110101111111011101110101010111010111000101010111111100011111110101110111111111011101111101000101110111110101110101111100011101110111110111011101
100000101010101010101010001000101010000000101010101010100010100000000000000000100010101010000000001010100000100000000000100000100000001000100000001000100000100010101000101000000010001000100010000000101
101010101010111010111011111011101011111011101010101010101110111011111110111110111110101111101111101010101110111110111110101110111011101110111010101110111110101011101110101111100011111011101110111110101
101010101010001000001000001010000000101010101010001010101000001010000010000010000000100000100000001010101010000010000010100010000000000000001010100010000010101000000000100000100000000010001000001010101
101110101011111011111011111011101110101110101110111010101111101110101110111010111111100011100011101011101011101011101110111011111011111111101010111011111010111011111011101111101111111110111000111011101
100000001000000010000010000000101010100000000000100010100000100000101010101000100000100010000010001010101000101000101010000000001010000000101010101010001000101000001010001000001000000000100000100000001
101111111010111011100011101111101011101110111110100010111010111110111011101110111110101110000011101110101110101110101011101111101110111011101011101110001110101111101011111011111000001111101110101111101
101000000010101000100000101000001000001010100010100010001010100010000000000010000010101000000000100000100000101010101000101000000000101010001000000000000010100000101000000010000000001000001010100000101
101011111110101110111011101111111000001010101110111011101011111011111110111110001110101011111110111000111111101010111010111011111111101011101011111011111010111110111011101111101111101111111010111110101
101010000000100010001010000000000000001010101000101000101000000000000010100000001000100010000010001000000000001010000010001010000000001000101010001000001010000000000010101000001000100000000010000010101
101011101111101010111010111110111011101011101011101110101110111111111010111010101010111110111110101011111111101010111010111010111011111000101110111111111010111011111110101110111011101111101010111110101
101000000000101000100000100010101010101000001010000010100010100000000010001010101010000000100000101000000000001010101010100010001010000000100000100000000010101010000000000010100010001000101010101000101
101111111000111010111011101010101110101110101010111010111011101111111110111011101010111111101110111011111110111011101010100011101011101110101110111111111010101010111111111011101011101011101010101110101
100010001000000010001010001010100000100010101000001010000000001000001000100000001010100000001010000010000010100000001010100000100000101010101000000000001000101010100000001000101000001010001010000010101
101011101011111010111010111110111110100010111111111010001110001111101111101111101110111110111011111010111110100000111010111110111110101010111011101110001110101010111111101110111011101011111011111010101
101000100010001010100010000000000010100010000000000010001010000000100000001000100000000010100000001010100000100000100010000010000010101010001010101010000010100010000000100010000010101000001000001010101
101011101110111011111011111110001110111110111111111011101010001110101110001110111110111110111011101010100011101111101110111010111110111011101110101011111010111111111110101110111110101000001111101110101
100010001000100000001000000010001000000000100000001000100010001010100010000010000010001000001000001010100010001000001000101010100000000000100000101010001010000000000010100000100000101000000000100000101
101110111011101111101011111011101111111111101010111011101111101010111110000011101110101111101110111010100010101011101110101110111111111110101110101010111010111110101110111010101110111011101111101110101
101000100000000010101010001000100000000010001010100010001000101010000000000000101000100000100010100010000010101010000010100000000000000000101010101010100010000010101000001000100010001010101000001000101
101111101011111110101010111010101110111011101010101110101010111011111111111000101010111111101110111011101110101010111011101110111111101110111010101010111011100011101110111110111111101010111011101110101
100000001010000000100010101010101010101000101010101000101010000000000000001000101010000000001000000000001000001010101000001010001010101010000010100010001000100010001010000010100000101000000010100010101
100000001110111111111110101110111011101111101110111111101011111011111111101111101110000000001111111111111011101110101111111011111010111011111110111110001111100011111011111011101111101111111110100011100
100000000000000000000000000000000000000000000000000000001000001010000000000000000000000000000000000000000000100000100000000000000000000000000000000000000000000000000000000000000000000000000000100000001
111111111111111111111111111111111111111111111111111111111111111111111111111111111111111111111111111111111111111111111111111111111111111111111111111111111111111111111111111111111111111111111111111111111